//MAP CONVERTED BY dmm2tgm.py THIS HEADER COMMENT PREVENTS RECONVERSION, DO NOT REMOVE
"aM" = (
/obj/structure/chair/sofa/left,
/turf/open/floor/plasteel/vaporwave,
/area/space)
"aO" = (
/turf/open/floor/plasteel/tech/grid,
/area/space)
"be" = (
/obj/machinery/door/airlock/external,
/turf/open/space/basic,
/area/space)
"bu" = (
/obj/structure/table/wood/reinforced,
/obj/item/flashlight/lamp/green,
/turf/open/floor/wood/walnut,
/area/space)
"bE" = (
/obj/structure/closet,
/turf/open/floor/plasteel/grimy,
/area/space)
"bH" = (
/obj/effect/turf_decal/atmos/air{
	dir = 1
	},
/obj/structure/window/plasma/reinforced/spawner,
/turf/open/floor/engine/air,
/area/space)
"bI" = (
/turf/closed/wall,
/area/space)
"cO" = (
/turf/open/floor/plasteel/white,
/area/space)
"dl" = (
/obj/effect/spawner/structure/window/reinforced/tinted,
/turf/open/floor/plating,
/area/space)
"dA" = (
/obj/machinery/atmospherics/components/trinary/filter/atmos/o2,
/turf/open/space/basic,
/area/space)
"ed" = (
/obj/machinery/computer/helm{
	dir = 8
	},
/turf/open/floor/plasteel/tech/techmaint,
/area/space)
"ei" = (
/obj/structure/bed,
/obj/item/bedsheet/random,
/turf/open/floor/wood/walnut,
/area/space)
"ek" = (
/obj/machinery/atmospherics/components/trinary/filter/atmos/n2,
/turf/open/space/basic,
/area/space)
"en" = (
/obj/structure/window/plasma/reinforced/spawner/west,
/obj/structure/window/plasma/reinforced/spawner,
/turf/open/floor/engine/air,
/area/space)
"eu" = (
/obj/structure/table,
/turf/open/floor/plasteel/patterned/cargo_one,
/area/space)
"eH" = (
/obj/structure/window/reinforced{
	dir = 8
	},
/turf/open/floor/plasteel/grimy,
/area/space)
"fg" = (
/turf/open/floor/plasteel/tech,
/area/space)
"fC" = (
/obj/machinery/shower{
	pixel_y = 19
	},
/obj/structure/toilet/secret{
	pixel_x = 4;
	pixel_y = 6
	},
/obj/structure/sink{
	dir = 4;
	pixel_y = 7;
	pixel_x = -12
	},
/obj/structure/curtain/cloth,
/turf/open/floor/plasteel/grimy,
/area/space)
"fO" = (
/obj/effect/turf_decal/industrial/warning{
	dir = 8
	},
/obj/machinery/light/small{
	dir = 1
	},
/turf/open/floor/plasteel/tech,
/area/space)
"gA" = (
/obj/structure/catwalk/over,
/turf/open/floor/plating,
/area/space)
"gC" = (
/turf/open/floor/plasteel/tech/techmaint,
/area/space)
"gH" = (
/obj/structure/railing{
	dir = 8
	},
/turf/open/floor/plasteel/stairs{
	dir = 1
	},
/area/space)
"hq" = (
/obj/machinery/atmospherics/components/unary/vent_pump/high_volume/siphon/atmos/air_output{
	piping_layer = 2;
	dir = 1
	},
/obj/structure/window/plasma/reinforced/spawner/north,
/obj/structure/window/plasma/reinforced/spawner/east,
/turf/open/floor/engine/air,
/area/space)
"hs" = (
/turf/open/floor/plasteel/dark,
/area/space)
"hx" = (
/obj/machinery/computer/crew{
	dir = 1
	},
/turf/open/floor/plasteel/tech/techmaint,
/area/space)
"hC" = (
/obj/machinery/door/poddoor/shutters{
	id = "cargo"
	},
/turf/open/floor/plating,
/area/space)
"ii" = (
/obj/machinery/computer/apc_control{
	dir = 1
	},
/turf/open/floor/pod/light,
/area/space)
"iq" = (
/obj/structure/catwalk/over/plated_catwalk/dark,
/obj/machinery/door/airlock/grunge,
/turf/open/floor/plating,
/area/space)
"jB" = (
/obj/structure/chair/sofa/right,
/turf/open/floor/plasteel/vaporwave,
/area/space)
"jJ" = (
/turf/open/space/basic,
/area/space)
"ka" = (
/obj/structure/table,
/turf/open/floor/plasteel/grimy,
/area/space)
"ku" = (
/turf/open/floor/engine/hull,
/area/space)
"kQ" = (
/turf/open/floor/pod/light,
/area/space)
"kS" = (
/obj/structure/window/plasma/reinforced/spawner,
/obj/effect/turf_decal/atmos/oxygen{
	dir = 1;
	pixel_x = -12
	},
/turf/open/floor/engine/o2,
/area/space)
"ma" = (
/obj/machinery/computer/security{
	dir = 1
	},
/turf/open/floor/plasteel/tech/techmaint,
/area/space)
"mc" = (
/obj/machinery/atmospherics/components/trinary/mixer/airmix/flipped{
	dir = 1
	},
/turf/open/space/basic,
/area/space)
"mA" = (
/obj/machinery/processor,
/turf/open/floor/plasteel/white,
/area/space)
"mV" = (
/obj/machinery/computer/crew{
	dir = 8
	},
/turf/open/floor/pod/light,
/area/space)
"nc" = (
/obj/machinery/portable_atmospherics/canister/oxygen,
/obj/machinery/atmospherics/components/unary/vent_pump/siphon/atmos/nitrogen_output{
	dir = 1;
	name = "inlet";
	on = 0
	},
/obj/machinery/light/small{
	dir = 8
	},
/turf/open/floor/plasteel/tech/grid,
/area/space)
"nB" = (
/turf/open/floor/wood/walnut,
/area/space)
"nP" = (
/obj/structure/window/plasma/reinforced/spawner/north,
/obj/machinery/atmospherics/components/unary/vent_pump/siphon/atmos/oxygen_output{
	dir = 1
	},
/turf/open/floor/engine/o2,
/area/space)
"nS" = (
/obj/structure/rack,
/turf/open/floor/mineral/plastitanium,
/area/space)
"os" = (
/obj/structure/dresser,
/turf/open/floor/wood/walnut,
/area/space)
"ot" = (
/obj/structure/railing,
/obj/machinery/atmospherics/pipe/manifold/brown/hidden{
	dir = 1
	},
/turf/open/floor/plasteel/tech/grid,
/area/space)
"po" = (
/turf/open/floor/wood/maple,
/area/space)
"qt" = (
/obj/structure/chair{
	dir = 4
	},
/turf/open/space/basic,
/area/space)
"qy" = (
/obj/structure/window/reinforced{
	dir = 1
	},
/turf/open/floor/mineral/plastitanium,
/area/space)
"qX" = (
/obj/structure/chair{
	dir = 1
	},
/turf/open/floor/plasteel/vaporwave,
/area/space)
"ri" = (
/obj/structure/railing{
	dir = 4
	},
/turf/open/floor/plasteel/stairs,
/area/space)
"ro" = (
/obj/machinery/power/smes/shuttle/precharged{
	dir = 4
	},
/obj/structure/window/reinforced{
	dir = 8
	},
/turf/open/floor/plating,
/area/space)
"rU" = (
/turf/open/floor/plasteel/patterned/cargo_one,
/area/space)
"sa" = (
/obj/machinery/atmospherics/pipe/heat_exchanging/junction,
/turf/closed/wall,
/area/space)
"sH" = (
/obj/structure/bed,
/obj/item/bedsheet/random,
/obj/structure/curtain/cloth/grey,
/turf/open/floor/plasteel/grimy,
/area/space)
"sW" = (
/obj/structure/railing{
	dir = 4
	},
/turf/open/floor/plasteel/vaporwave,
/area/space)
"ts" = (
/obj/machinery/door/airlock/command,
/turf/open/floor/wood/maple,
/area/space)
"ux" = (
/turf/open/floor/plasteel/grimy,
/area/space)
"uy" = (
/obj/machinery/atmospherics/pipe/simple/brown/hidden{
	dir = 9
	},
/turf/open/floor/plasteel/tech/grid,
/area/space)
"uF" = (
/obj/machinery/atmospherics/pipe/manifold/brown/hidden,
/turf/open/floor/plasteel/tech/grid,
/area/space)
"uN" = (
/obj/structure/table/reinforced,
/turf/open/floor/plasteel/vaporwave,
/area/space)
"uQ" = (
/obj/machinery/cryopod{
	dir = 4
	},
/turf/open/floor/plasteel/tech/grid,
/area/space)
"vV" = (
/obj/structure/catwalk/over/plated_catwalk/dark,
/obj/machinery/atmospherics/components/unary/outlet_injector/atmos/nitrogen_input{
	name = "injector";
	on = 0
	},
/obj/structure/tank_dispenser/oxygen,
/obj/structure/railing,
/turf/open/floor/plasteel/tech/grid,
/area/space)
"wk" = (
/obj/machinery/power/shuttle/engine/electric{
	dir = 4
	},
/turf/open/floor/plating,
/area/space)
"wr" = (
/obj/machinery/suit_storage_unit/inherit/industrial,
/obj/machinery/atmospherics/components/unary/vent_pump/siphon/atmos/nitrogen_output{
	dir = 1;
	name = "inlet";
	on = 0
	},
/turf/open/floor/plasteel/tech/grid,
/area/space)
"wN" = (
/obj/structure/window/plasma/reinforced/spawner/west,
/obj/structure/window/plasma/reinforced/spawner/north,
/turf/open/floor/engine/o2,
/area/space)
"xb" = (
/obj/structure/chair/office{
	dir = 1
	},
/turf/open/floor/pod/light,
/area/space)
"xt" = (
/obj/machinery/door/airlock/security/glass,
/turf/open/floor/mineral/plastitanium,
/area/space)
"xB" = (
/obj/machinery/computer/atmos_control/tank/nitrogen_tank{
	dir = 1;
	name = "Cargo Bay Control"
	},
/obj/machinery/atmospherics/components/unary/vent_pump/siphon/atmos/nitrogen_output{
	dir = 1;
	name = "inlet";
	on = 0
	},
/turf/open/floor/plasteel/tech/grid,
/area/space)
"xQ" = (
/obj/structure/bed,
/obj/item/bedsheet/random,
/turf/open/floor/plasteel/grimy,
/area/space)
"xW" = (
/obj/machinery/air_sensor/atmos/air_tank,
/obj/structure/window/plasma/reinforced/spawner/north,
/turf/open/floor/engine/air,
/area/space)
"yE" = (
/obj/machinery/door/airlock/grunge,
/turf/open/space/basic,
/area/space)
"zz" = (
/obj/structure/chair/office/light{
	dir = 1
	},
/turf/open/floor/mineral/plastitanium,
/area/space)
"zG" = (
/obj/machinery/door/airlock/grunge,
/obj/structure/catwalk/over/plated_catwalk/dark,
/turf/open/floor/plating,
/area/space)
"AP" = (
/obj/machinery/cryopod{
	dir = 4
	},
/obj/machinery/computer/cryopod{
	pixel_y = 26
	},
/turf/open/floor/wood/walnut,
/area/space)
"Cp" = (
/obj/machinery/computer/security,
/turf/open/floor/mineral/plastitanium,
/area/space)
"CC" = (
/turf/open/floor/pod/dark,
/area/space)
"DO" = (
/obj/structure/table/reinforced,
/obj/machinery/microwave,
/turf/open/floor/plasteel/white,
/area/space)
"Ec" = (
/obj/structure/table/reinforced,
/turf/open/floor/plasteel/tech,
/area/space)
"Ed" = (
/obj/structure/catwalk/over/plated_catwalk/dark,
/obj/machinery/atmospherics/components/unary/outlet_injector/atmos/nitrogen_input{
	name = "injector";
	on = 0
	},
/obj/machinery/ore_silo,
/obj/structure/railing,
/turf/open/floor/plasteel/tech/grid,
/area/space)
"Es" = (
/obj/structure/closet,
/turf/open/floor/mineral/plastitanium,
/area/space)
"Ey" = (
/obj/structure/window/plasma/reinforced/spawner/north,
/obj/structure/window/plasma/reinforced/spawner/west,
/turf/open/floor/engine/air,
/area/space)
"EX" = (
/obj/structure/table/reinforced,
/turf/open/floor/plasteel/white,
/area/space)
"Fm" = (
/obj/machinery/computer/atmos_alert{
	dir = 8
	},
/turf/open/floor/pod/light,
/area/space)
"Ha" = (
/obj/structure/railing{
	dir = 8
	},
/turf/open/floor/plasteel/stairs,
/area/space)
"HL" = (
/obj/structure/catwalk/over/plated_catwalk/dark,
/turf/open/space/basic,
/area/space)
"HO" = (
/obj/structure/railing,
/turf/open/floor/plasteel/tech,
/area/space)
"IL" = (
/obj/structure/window/plasma/reinforced/spawner/west,
/obj/structure/window/plasma/reinforced/spawner,
/obj/machinery/air_sensor/atmos/toxin_tank{
	id_tag = "nemo_tox_sensor"
	},
/turf/open/floor/engine/plasma,
/area/space)
"Ju" = (
/obj/machinery/power/terminal{
	dir = 8
	},
/turf/open/floor/plating,
/area/space)
"JM" = (
/obj/machinery/modular_computer/console/preset/command,
/turf/open/floor/pod/light,
/area/space)
"JW" = (
/obj/structure/window/plasma/reinforced/spawner/east,
/obj/structure/window/plasma/reinforced/spawner,
/turf/open/floor/engine/air,
/area/space)
"Ke" = (
/obj/machinery/power/terminal{
	dir = 8
	},
/obj/structure/window/reinforced{
	dir = 1
	},
/turf/open/floor/mineral/plastitanium,
/area/space)
"Ki" = (
/obj/structure/catwalk/over/plated_catwalk/dark,
/turf/open/floor/plating,
/area/space)
"KP" = (
/obj/machinery/modular_computer/console/preset/command{
	dir = 8
	},
/obj/machinery/light/small{
	dir = 4
	},
/turf/open/floor/plasteel/tech/techmaint,
/area/space)
"Lc" = (
/obj/machinery/modular_computer/console/preset/command{
	dir = 1
	},
/turf/open/floor/pod/light,
/area/space)
"Ll" = (
/obj/machinery/light/small{
	dir = 1
	},
/turf/open/floor/wood/walnut,
/area/space)
"Lw" = (
/obj/structure/table,
/turf/open/floor/plasteel/tech,
/area/space)
"LG" = (
/turf/open/floor/vault,
/area/space)
"LH" = (
/obj/machinery/power/terminal{
	dir = 8
	},
/turf/open/floor/mineral/plastitanium,
/area/space)
"Mp" = (
/obj/structure/window/plasma/reinforced/spawner/east,
/obj/structure/window/plasma/reinforced/spawner,
/obj/effect/turf_decal/atmos/plasma{
	dir = 1;
	pixel_x = -11
	},
/turf/open/floor/engine/plasma,
/area/space)
"MM" = (
/obj/machinery/door/airlock/grunge,
/turf/open/floor/pod/light,
/area/space)
"MU" = (
/obj/structure/chair{
	dir = 1
	},
/turf/open/floor/mineral/plastitanium,
/area/space)
"MW" = (
/obj/machinery/power/smes/shuttle/precharged{
	dir = 4
	},
/obj/structure/window/reinforced{
	dir = 8
	},
/turf/open/floor/mineral/plastitanium,
/area/space)
"Og" = (
/obj/structure/window/reinforced{
	dir = 8
	},
/obj/structure/closet,
/turf/open/floor/plasteel/grimy,
/area/space)
"OJ" = (
/obj/machinery/door/airlock/grunge,
/turf/open/floor/plating,
/area/space)
"OY" = (
/obj/machinery/atmospherics/pipe/simple/brown/hidden{
	dir = 4
	},
/obj/machinery/door/poddoor/shutters{
	id = "Internal";
	name = "internal shutters"
	},
/obj/structure/catwalk/over/plated_catwalk/dark,
/turf/open/floor/plating,
/area/space)
"Pe" = (
/obj/structure/window/plasma/reinforced/spawner,
/obj/structure/window/plasma/reinforced/spawner/west,
/obj/machinery/air_sensor/atmos/oxygen_tank{
	id_tag = "nemo_o2_sensor"
	},
/turf/open/floor/engine/o2,
/area/space)
"PZ" = (
/obj/structure/closet/secure_closet/freezer/fridge/open,
/turf/open/floor/plasteel/white,
/area/space)
"Qk" = (
/obj/structure/table,
/obj/machinery/microwave,
/turf/open/floor/plasteel/grimy,
/area/space)
"Qu" = (
/obj/structure/table,
/turf/open/space/basic,
/area/space)
"Rm" = (
/turf/open/floor/pod,
/area/space)
"RM" = (
/obj/structure/chair/office/light,
/turf/open/floor/pod/light,
/area/space)
"Ss" = (
/obj/machinery/atmospherics/pipe/simple/brown/hidden{
	dir = 10
	},
/obj/structure/railing,
/turf/open/floor/plasteel/tech/grid,
/area/space)
"Su" = (
/obj/structure/chair{
	dir = 1
	},
/turf/open/floor/plasteel/grimy,
/area/space)
"SZ" = (
/turf/open/floor/plating,
/area/space)
"Tn" = (
/obj/machinery/computer/card,
/turf/open/floor/plasteel/tech,
/area/space)
"Tr" = (
/turf/open/floor/mineral/plastitanium,
/area/space)
"TF" = (
/obj/structure/window/plasma/reinforced/spawner/north,
/obj/structure/window/plasma/reinforced/spawner/east,
/obj/machinery/atmospherics/components/unary/vent_pump/siphon/atmos/toxin_output{
	dir = 1
	},
/turf/open/floor/engine/plasma,
/area/space)
"Ua" = (
/obj/machinery/door/airlock/wood,
/turf/open/floor/wood/walnut,
/area/space)
"Ub" = (
/obj/machinery/light/small{
	dir = 8
	},
/turf/open/floor/plasteel/stairs,
/area/space)
"Uo" = (
/obj/structure/railing,
/obj/structure/closet,
/turf/open/floor/plasteel/tech,
/area/space)
"UK" = (
/obj/structure/railing{
	dir = 4
	},
/turf/open/floor/plasteel/stairs{
	dir = 1
	},
/area/space)
"Vr" = (
/obj/structure/closet/crate/secure/loot{
	name = "locked crate"
	},
/turf/open/floor/plasteel/patterned/cargo_one,
/area/space)
"Vt" = (
/obj/structure/chair{
	dir = 8
	},
/turf/open/space/basic,
/area/space)
"VA" = (
/obj/effect/turf_decal/industrial/warning{
	dir = 8
	},
/turf/open/floor/plasteel/tech,
/area/space)
"VS" = (
/obj/effect/spawner/structure/window/reinforced,
/turf/open/floor/plating,
/area/space)
"Wu" = (
/obj/structure/closet/secure_closet/freezer/fridge,
/turf/open/floor/plasteel/grimy,
/area/space)
"WJ" = (
/obj/machinery/atmospherics/pipe/heat_exchanging/junction{
	dir = 1
	},
/turf/closed/wall,
/area/space)
"WL" = (
/obj/machinery/door/window/southleft,
/turf/open/floor/plasteel/grimy,
/area/space)
"WW" = (
/obj/machinery/computer/helm{
	dir = 8
	},
/turf/open/floor/pod/light,
/area/space)
"XG" = (
/obj/machinery/computer/card{
	dir = 8
	},
/turf/open/floor/pod/light,
/area/space)
"XW" = (
/obj/structure/catwalk/over/plated_catwalk/dark,
/obj/machinery/atmospherics/components/unary/outlet_injector/atmos/nitrogen_input{
	name = "injector";
	on = 0
	},
/obj/structure/rack,
/obj/structure/railing,
/turf/open/floor/plasteel/tech/grid,
/area/space)
"Yx" = (
/obj/structure/closet,
/turf/open/floor/pod/light,
/area/space)
"YR" = (
/obj/machinery/door/airlock/external/glass,
/turf/open/space/basic,
/area/space)
"Zq" = (
/obj/machinery/computer/security,
/turf/open/floor/pod/light,
/area/space)
"Zr" = (
/obj/structure/catwalk/over/plated_catwalk/dark,
/obj/machinery/atmospherics/components/unary/outlet_injector/atmos/nitrogen_input{
	name = "injector";
	on = 0
	},
/obj/machinery/computer/cargo/express,
/obj/structure/railing,
/obj/machinery/light/small{
	dir = 1
	},
/turf/open/floor/plasteel/tech/grid,
/area/space)
"Zt" = (
/obj/structure/table,
/turf/open/floor/pod,
/area/space)
"ZY" = (
/obj/structure/window/plasma/reinforced/spawner/north,
/obj/structure/window/plasma/reinforced/spawner/west,
/turf/open/floor/engine/plasma,
/area/space)

(1,1,1) = {"
jJ
jJ
jJ
jJ
jJ
jJ
jJ
jJ
jJ
jJ
jJ
jJ
jJ
jJ
jJ
jJ
jJ
jJ
jJ
jJ
jJ
jJ
jJ
jJ
jJ
jJ
jJ
jJ
jJ
jJ
jJ
jJ
jJ
jJ
jJ
jJ
jJ
jJ
jJ
jJ
"}
(2,1,1) = {"
jJ
jJ
jJ
jJ
jJ
jJ
jJ
jJ
jJ
jJ
jJ
jJ
jJ
jJ
jJ
jJ
jJ
jJ
jJ
jJ
jJ
jJ
jJ
jJ
jJ
jJ
jJ
jJ
jJ
jJ
jJ
jJ
jJ
jJ
jJ
jJ
jJ
jJ
jJ
jJ
"}
(3,1,1) = {"
jJ
jJ
jJ
jJ
jJ
jJ
jJ
jJ
jJ
jJ
jJ
jJ
jJ
jJ
jJ
jJ
jJ
jJ
jJ
jJ
jJ
jJ
jJ
jJ
jJ
jJ
jJ
jJ
jJ
jJ
jJ
jJ
jJ
jJ
jJ
jJ
jJ
jJ
jJ
jJ
"}
(4,1,1) = {"
jJ
jJ
jJ
jJ
jJ
jJ
jJ
jJ
jJ
jJ
jJ
jJ
jJ
jJ
jJ
jJ
jJ
jJ
jJ
jJ
jJ
jJ
jJ
jJ
jJ
jJ
jJ
jJ
jJ
jJ
jJ
jJ
jJ
jJ
jJ
jJ
jJ
jJ
jJ
jJ
"}
(5,1,1) = {"
jJ
jJ
jJ
jJ
jJ
jJ
jJ
jJ
jJ
jJ
jJ
jJ
jJ
jJ
jJ
jJ
jJ
jJ
jJ
jJ
jJ
jJ
jJ
jJ
jJ
jJ
jJ
jJ
jJ
jJ
jJ
jJ
jJ
jJ
jJ
jJ
jJ
jJ
jJ
jJ
"}
(6,1,1) = {"
jJ
jJ
jJ
jJ
jJ
jJ
jJ
jJ
jJ
jJ
jJ
jJ
jJ
bI
bI
xt
xt
bI
bI
jJ
jJ
jJ
jJ
jJ
jJ
jJ
jJ
jJ
jJ
jJ
jJ
jJ
jJ
jJ
jJ
jJ
jJ
jJ
jJ
jJ
"}
(7,1,1) = {"
jJ
jJ
jJ
jJ
jJ
jJ
jJ
jJ
jJ
jJ
jJ
jJ
bI
bI
Es
Tr
Tr
Es
bI
bI
jJ
jJ
jJ
jJ
jJ
jJ
jJ
jJ
jJ
jJ
jJ
jJ
jJ
jJ
jJ
jJ
jJ
jJ
jJ
jJ
"}
(8,1,1) = {"
jJ
jJ
jJ
jJ
jJ
jJ
jJ
jJ
jJ
jJ
jJ
jJ
bI
bI
nS
Tr
Tr
MU
bI
bI
jJ
jJ
jJ
jJ
jJ
jJ
jJ
jJ
jJ
jJ
jJ
jJ
jJ
jJ
jJ
jJ
jJ
jJ
jJ
jJ
"}
(9,1,1) = {"
jJ
jJ
jJ
jJ
jJ
jJ
jJ
jJ
jJ
jJ
jJ
jJ
jJ
bI
Cp
zz
Tr
MU
bI
jJ
jJ
jJ
jJ
jJ
jJ
jJ
jJ
jJ
jJ
jJ
jJ
jJ
jJ
jJ
jJ
jJ
jJ
jJ
jJ
jJ
"}
(10,1,1) = {"
jJ
jJ
jJ
jJ
jJ
jJ
jJ
jJ
jJ
jJ
jJ
jJ
jJ
jJ
jJ
jJ
jJ
jJ
jJ
jJ
jJ
jJ
jJ
jJ
jJ
jJ
jJ
jJ
jJ
jJ
jJ
jJ
jJ
jJ
jJ
jJ
jJ
jJ
jJ
jJ
"}
(11,1,1) = {"
jJ
jJ
jJ
jJ
jJ
jJ
jJ
jJ
jJ
jJ
jJ
jJ
jJ
jJ
jJ
jJ
jJ
jJ
jJ
jJ
jJ
jJ
jJ
jJ
jJ
jJ
jJ
jJ
bI
be
be
bI
jJ
jJ
jJ
jJ
jJ
jJ
jJ
jJ
"}
(12,1,1) = {"
jJ
jJ
jJ
jJ
jJ
jJ
jJ
jJ
jJ
jJ
jJ
jJ
jJ
jJ
jJ
jJ
jJ
jJ
jJ
jJ
jJ
jJ
jJ
jJ
jJ
jJ
jJ
bI
bI
jJ
jJ
bI
bI
jJ
jJ
jJ
jJ
jJ
jJ
jJ
"}
(13,1,1) = {"
jJ
jJ
jJ
jJ
jJ
jJ
jJ
jJ
jJ
jJ
jJ
jJ
jJ
jJ
jJ
jJ
jJ
jJ
jJ
jJ
jJ
jJ
jJ
jJ
jJ
bI
wk
bI
bI
YR
YR
bI
bI
wk
bI
jJ
jJ
jJ
jJ
jJ
"}
(14,1,1) = {"
jJ
jJ
jJ
jJ
jJ
jJ
bI
bI
bI
jJ
jJ
jJ
jJ
jJ
jJ
jJ
jJ
jJ
jJ
jJ
jJ
jJ
jJ
bI
wk
bI
MW
bI
LG
LG
LG
LG
bI
ro
bI
wk
bI
jJ
jJ
jJ
"}
(15,1,1) = {"
jJ
jJ
jJ
jJ
jJ
jJ
jB
uN
qX
jJ
jJ
jJ
jJ
jJ
jJ
jJ
jJ
jJ
jJ
jJ
jJ
jJ
bI
bI
MW
Tr
LH
bI
LG
LG
LG
LG
bI
Ju
jJ
ro
bI
bI
jJ
jJ
"}
(16,1,1) = {"
jJ
jJ
jJ
jJ
jJ
jJ
aM
uN
qX
jJ
jJ
jJ
jJ
jJ
jJ
jJ
jJ
jJ
jJ
jJ
jJ
jJ
bI
xQ
Ke
Tr
Tr
bI
LG
LG
LG
LG
bI
jJ
jJ
Ju
jJ
bI
jJ
jJ
"}
(17,1,1) = {"
jJ
jJ
jJ
jJ
jJ
jJ
sW
sW
sW
jJ
jJ
jJ
jJ
jJ
jJ
jJ
jJ
jJ
jJ
jJ
jJ
bI
bI
ux
eH
qy
Tr
yE
LG
LG
LG
LG
OJ
jJ
jJ
jJ
jJ
bI
bI
jJ
"}
(18,1,1) = {"
jJ
jJ
jJ
jJ
jJ
jJ
mA
cO
cO
jJ
jJ
jJ
jJ
jJ
jJ
jJ
jJ
jJ
jJ
jJ
jJ
bI
ka
ux
ux
qy
Tr
yE
LG
LG
LG
LG
OJ
jJ
jJ
jJ
jJ
jJ
bI
jJ
"}
(19,1,1) = {"
jJ
jJ
jJ
jJ
jJ
jJ
EX
cO
cO
jJ
jJ
jJ
jJ
jJ
jJ
jJ
jJ
jJ
jJ
jJ
jJ
VS
ka
Su
ux
Tr
Tr
bI
LG
LG
LG
LG
bI
jJ
jJ
jJ
jJ
jJ
VS
jJ
"}
(20,1,1) = {"
jJ
jJ
jJ
jJ
jJ
jJ
DO
cO
PZ
jJ
jJ
jJ
jJ
jJ
jJ
jJ
jJ
jJ
jJ
jJ
jJ
VS
ux
ux
ux
qy
Tr
bI
bI
MM
MM
bI
bI
jJ
jJ
jJ
jJ
jJ
VS
jJ
"}
(21,1,1) = {"
jJ
jJ
jJ
jJ
jJ
jJ
bI
bI
bI
jJ
jJ
jJ
jJ
jJ
jJ
jJ
jJ
jJ
jJ
jJ
jJ
bI
bI
bI
bI
bI
bI
bI
Yx
kQ
kQ
Yx
bI
bI
jJ
jJ
jJ
jJ
bI
jJ
"}
(22,1,1) = {"
jJ
jJ
jJ
jJ
jJ
jJ
jJ
jJ
jJ
jJ
jJ
jJ
jJ
jJ
jJ
jJ
jJ
jJ
jJ
jJ
jJ
bI
jJ
jJ
jJ
jJ
bI
Zq
kQ
kQ
kQ
kQ
ii
bI
jJ
jJ
jJ
jJ
bI
jJ
"}
(23,1,1) = {"
jJ
jJ
jJ
AP
ei
ei
dl
po
jJ
jJ
jJ
jJ
jJ
jJ
jJ
jJ
jJ
jJ
jJ
jJ
jJ
WJ
jJ
jJ
Ki
jJ
VS
JM
xb
kQ
kQ
RM
Lc
VS
jJ
Ki
jJ
jJ
sa
jJ
"}
(24,1,1) = {"
jJ
jJ
jJ
Ll
nB
nB
dl
po
jJ
jJ
jJ
jJ
jJ
jJ
jJ
jJ
jJ
jJ
jJ
jJ
jJ
bI
jJ
jJ
Ki
jJ
bI
bI
mV
Fm
WW
XG
bI
bI
jJ
Ki
jJ
jJ
bI
jJ
"}
(25,1,1) = {"
jJ
jJ
jJ
bu
os
nB
Ua
po
jJ
jJ
jJ
jJ
jJ
jJ
jJ
jJ
jJ
SZ
gA
ku
jJ
bI
jJ
jJ
Ki
jJ
jJ
bI
bI
VS
VS
bI
bI
Rm
Rm
Ki
Rm
Rm
bI
jJ
"}
(26,1,1) = {"
jJ
jJ
jJ
jJ
jJ
jJ
jJ
jJ
jJ
jJ
jJ
jJ
jJ
jJ
jJ
jJ
jJ
rU
HL
jJ
jJ
WJ
jJ
jJ
Ki
jJ
jJ
bI
eu
rU
rU
rU
bI
Rm
Rm
Ki
Rm
Rm
sa
jJ
"}
(27,1,1) = {"
jJ
jJ
jJ
jJ
jJ
jJ
wN
Pe
jJ
jJ
jJ
jJ
jJ
jJ
jJ
jJ
jJ
kQ
jJ
jJ
jJ
bI
jJ
jJ
Ki
jJ
jJ
bI
eu
rU
rU
Vr
bI
Rm
Rm
Ki
Rm
Rm
bI
jJ
"}
(28,1,1) = {"
jJ
jJ
jJ
jJ
jJ
jJ
nP
kS
jJ
jJ
jJ
jJ
jJ
jJ
jJ
jJ
jJ
Tr
jJ
jJ
jJ
bI
jJ
jJ
Ki
jJ
jJ
bI
rU
rU
rU
Vr
bI
Rm
Rm
Ki
Rm
Rm
bI
jJ
"}
(29,1,1) = {"
jJ
jJ
jJ
jJ
jJ
jJ
ZY
IL
jJ
jJ
jJ
jJ
jJ
jJ
jJ
jJ
jJ
hs
jJ
jJ
jJ
bI
jJ
jJ
Ki
Ki
Ki
hC
Ha
Ki
Ki
gH
hC
Ki
Ki
Ki
Rm
Rm
bI
jJ
"}
(30,1,1) = {"
jJ
jJ
jJ
jJ
jJ
jJ
TF
Mp
jJ
jJ
jJ
jJ
jJ
jJ
jJ
jJ
jJ
ux
jJ
jJ
jJ
bI
jJ
jJ
Ki
Ki
Ki
hC
ri
Ki
Ki
UK
hC
Ki
Ki
Ki
Rm
Zt
bI
jJ
"}
(31,1,1) = {"
jJ
jJ
jJ
jJ
jJ
jJ
jJ
jJ
jJ
jJ
jJ
jJ
jJ
jJ
jJ
jJ
jJ
LG
jJ
jJ
jJ
bI
bI
bI
bI
jJ
jJ
bI
Vr
Ki
Ki
rU
bI
bI
bI
iq
bI
bI
bI
jJ
"}
(32,1,1) = {"
jJ
jJ
jJ
jJ
jJ
jJ
jJ
jJ
jJ
jJ
jJ
jJ
jJ
jJ
jJ
jJ
jJ
fg
jJ
jJ
jJ
bI
uQ
uQ
dl
jJ
qt
bI
bI
OY
OY
bI
bI
SZ
SZ
SZ
SZ
SZ
bI
jJ
"}
(33,1,1) = {"
jJ
jJ
jJ
jJ
jJ
mc
jJ
jJ
jJ
jJ
jJ
jJ
jJ
jJ
jJ
jJ
jJ
aO
jJ
jJ
jJ
bI
fO
VA
dl
jJ
Qu
VS
vV
uF
ot
nc
VS
SZ
SZ
SZ
Ey
en
bI
jJ
"}
(34,1,1) = {"
jJ
jJ
jJ
ek
jJ
dA
jJ
jJ
jJ
jJ
jJ
jJ
jJ
jJ
jJ
jJ
jJ
gC
jJ
jJ
jJ
bI
Lw
fg
OJ
jJ
Vt
bI
XW
uF
ot
wr
bI
SZ
SZ
SZ
xW
bH
bI
jJ
"}
(35,1,1) = {"
jJ
jJ
jJ
jJ
jJ
jJ
jJ
jJ
jJ
jJ
jJ
jJ
jJ
jJ
jJ
jJ
jJ
Rm
jJ
jJ
jJ
bI
bI
bI
bI
zG
bI
bI
Zr
uF
ot
wr
bI
SZ
SZ
SZ
hq
JW
bI
jJ
"}
(36,1,1) = {"
jJ
jJ
jJ
bI
bI
bI
bI
ts
jJ
jJ
jJ
jJ
jJ
jJ
jJ
jJ
jJ
CC
jJ
jJ
jJ
bI
fC
WL
ux
ux
Qk
VS
Ed
uy
Ss
xB
VS
SZ
SZ
SZ
SZ
SZ
bI
jJ
"}
(37,1,1) = {"
jJ
jJ
jJ
Tn
fg
Ub
gC
gC
jJ
jJ
jJ
jJ
jJ
jJ
jJ
jJ
jJ
jJ
jJ
jJ
jJ
bI
Og
eH
ux
ux
ka
bI
bI
gA
gA
bI
bI
SZ
SZ
SZ
SZ
SZ
bI
jJ
"}
(38,1,1) = {"
jJ
jJ
jJ
Ec
HO
gC
gC
hx
jJ
jJ
jJ
jJ
jJ
jJ
jJ
jJ
jJ
jJ
jJ
jJ
jJ
bI
bE
ux
ux
ux
Wu
bI
gA
gA
gA
gA
bI
SZ
SZ
SZ
SZ
SZ
bI
jJ
"}
(39,1,1) = {"
jJ
jJ
jJ
Ec
HO
gC
gC
ma
jJ
jJ
jJ
jJ
jJ
jJ
jJ
jJ
jJ
jJ
jJ
jJ
jJ
bI
bI
sH
sH
sH
bI
bI
jJ
jJ
jJ
jJ
bI
bI
SZ
SZ
SZ
bI
bI
jJ
"}
(40,1,1) = {"
jJ
jJ
jJ
bI
Uo
KP
ed
VS
jJ
jJ
jJ
jJ
jJ
jJ
jJ
jJ
jJ
jJ
jJ
jJ
jJ
jJ
bI
bI
bI
bI
bI
jJ
jJ
jJ
jJ
jJ
jJ
bI
bI
bI
bI
bI
jJ
jJ
"}
