//MAP CONVERTED BY dmm2tgm.py THIS HEADER COMMENT PREVENTS RECONVERSION, DO NOT REMOVE
"aM" = (
/obj/effect/turf_decal/borderfloor,
/turf/open/floor/plasteel/mono/dark,
/area/space)
"aO" = (
/obj/effect/turf_decal/trimline/opaque/brown/line{
	dir = 8
	},
/obj/effect/decal/cleanable/dirt/dust,
/turf/open/floor/plasteel/patterned/cargo_one,
/area/space)
"be" = (
/obj/effect/turf_decal/trimline/opaque/brown/line,
/obj/machinery/light/small/broken,
/turf/open/floor/plasteel/patterned/cargo_one,
/area/space)
"bu" = (
/obj/machinery/door/window{
	dir = 4
	},
/turf/open/floor/plating,
/area/space)
"bD" = (
/obj/effect/turf_decal/trimline/opaque/brown/line{
	dir = 8
	},
/obj/effect/decal/cleanable/blood/drip,
/obj/effect/decal/cleanable/blood/tracks{
	dir = 10
	},
/turf/open/floor/plasteel/patterned/cargo_one,
/area/space)
"bE" = (
/obj/structure/door_assembly/door_assembly_grunge,
/turf/open/floor/pod/light,
/area/space)
"bH" = (
/obj/effect/turf_decal/atmos/air{
	dir = 1
	},
/obj/structure/window/plasma/reinforced/spawner,
/turf/open/floor/engine/air,
/area/space)
"bI" = (
/turf/closed/wall,
/area/space)
"bS" = (
/obj/structure/table,
/obj/effect/turf_decal/corner_techfloor_gray{
	dir = 4
	},
/obj/machinery/light/small/broken,
/turf/open/floor/plasteel/tech/grid,
/area/space)
"cg" = (
/obj/item/storage/secure/safe{
	pixel_y = 35;
	pixel_x = 7
	},
/turf/open/floor/vault,
/area/space)
"cs" = (
/obj/structure/window/plasma/reinforced/spawner/north,
/obj/structure/window/plasma/reinforced/spawner/west,
/obj/structure/window/plasma/reinforced/spawner/east,
/turf/open/floor/plating,
/area/space)
"cw" = (
/obj/structure/chair,
/turf/open/floor/plasteel/tech/techmaint,
/area/space)
"cK" = (
/obj/structure/table,
/obj/effect/turf_decal/corner_techfloor_gray,
/turf/open/floor/plasteel/tech/grid,
/area/space)
"cO" = (
/obj/effect/turf_decal/trimline/opaque/brown/line,
/obj/structure/fermenting_barrel,
/obj/effect/decal/cleanable/dirt/dust,
/obj/effect/decal/cleanable/dirt/dust,
/turf/open/floor/plasteel/patterned/cargo_one,
/area/space)
"dj" = (
/obj/structure/toilet{
	pixel_y = 12
	},
/obj/machinery/shower{
	dir = 1
	},
/obj/machinery/light/small{
	dir = 8
	},
/turf/open/floor/plastic,
/area/space)
"dl" = (
/obj/effect/spawner/structure/window/reinforced/tinted,
/turf/open/floor/plating,
/area/space)
"dA" = (
/obj/structure/table,
/obj/machinery/light/small{
	dir = 1
	},
/turf/open/floor/plasteel/patterned/grid,
/area/space)
"ed" = (
/obj/structure/door_assembly/door_assembly_grunge,
/turf/open/floor/plating,
/area/space)
"ei" = (
/obj/structure/closet/crate/secure/loot{
	name = "locked crate"
	},
/obj/effect/turf_decal/trimline/opaque/brown/line{
	dir = 5
	},
/obj/item/storage/backpack/satchel/flat,
/obj/effect/decal/cleanable/dirt/dust,
/obj/effect/decal/cleanable/dirt/dust,
/turf/open/floor/plasteel/patterned/cargo_one,
/area/space)
"ek" = (
/obj/machinery/power/smes/shuttle/precharged{
	dir = 4
	},
/obj/structure/window/reinforced{
	dir = 8
	},
/obj/machinery/door/window{
	dir = 4
	},
/turf/open/floor/plating,
/area/space)
"en" = (
/obj/structure/window/plasma/reinforced/spawner/west,
/obj/structure/window/plasma/reinforced/spawner,
/turf/open/floor/engine/air,
/area/space)
"eu" = (
/obj/machinery/atmospherics/pipe/simple/brown/hidden{
	dir = 9
	},
/obj/effect/turf_decal/trimline/opaque/orange/filled/warning{
	dir = 4
	},
/obj/effect/decal/cleanable/dirt/dust,
/obj/effect/decal/cleanable/dirt/dust,
/turf/open/floor/plasteel/tech/grid,
/area/space)
"fg" = (
/turf/open/floor/plasteel/tech,
/area/space)
"fC" = (
/obj/structure/chair{
	dir = 4
	},
/turf/open/floor/plasteel/grimy,
/area/space)
"fO" = (
/obj/effect/turf_decal/industrial/warning{
	dir = 8
	},
/obj/machinery/light/small{
	dir = 1
	},
/turf/open/floor/plasteel/tech,
/area/space)
"gA" = (
/obj/structure/catwalk/over,
/turf/open/floor/plating,
/area/space)
"gC" = (
/turf/open/floor/plasteel/tech/techmaint,
/area/space)
"gH" = (
/obj/structure/railing{
	dir = 8
	},
/turf/open/floor/plasteel/stairs{
	dir = 1
	},
/area/space)
"hq" = (
/obj/machinery/atmospherics/components/unary/vent_pump/high_volume/siphon/atmos/air_output{
	piping_layer = 2;
	dir = 1
	},
/obj/structure/window/plasma/reinforced/spawner/north,
/obj/structure/window/plasma/reinforced/spawner/east,
/turf/open/floor/engine/air,
/area/space)
"hs" = (
/obj/effect/decal/cleanable/dirt/dust,
/turf/open/floor/plasteel/patterned/cargo_one,
/area/space)
"hx" = (
/obj/effect/turf_decal/trimline/opaque/brown/line{
	dir = 5
	},
/obj/structure/closet/crate,
/obj/item/clothing/head/welding,
/turf/open/floor/plasteel/patterned/cargo_one,
/area/space)
"hC" = (
/obj/machinery/door/poddoor/shutters{
	id = "cargo"
	},
/obj/structure/catwalk/over/plated_catwalk/dark,
/turf/open/floor/plating,
/area/space)
"hX" = (
/turf/open/floor/plasteel/mono/dark,
/area/space)
"ii" = (
/obj/effect/turf_decal/trimline/opaque/brown/line{
	dir = 9
	},
/obj/effect/decal/cleanable/blood,
/obj/structure/closet/crate,
/obj/item/storage/toolbox/mechanical,
/obj/machinery/light/small{
	dir = 1
	},
/turf/open/floor/plasteel/patterned/cargo_one,
/area/space)
"iq" = (
/obj/structure/catwalk/over/plated_catwalk/dark,
/obj/machinery/door/airlock/grunge,
/obj/structure/catwalk/over/plated_catwalk/dark,
/turf/open/floor/plating,
/area/space)
"jb" = (
/obj/structure/closet/wall/red{
	pixel_y = 29
	},
/obj/item/kitchen/knife/combat,
/obj/item/kitchen/knife/combat,
/turf/open/floor/plasteel/patterned/grid,
/area/space)
"jB" = (
/obj/effect/turf_decal/trimline/opaque/brown/line,
/turf/open/floor/plasteel/patterned/cargo_one,
/area/space)
"jJ" = (
/obj/structure/girder,
/turf/open/floor/plating,
/area/space)
"jM" = (
/obj/effect/turf_decal/trimline/opaque/brown/line,
/obj/effect/decal/cleanable/blood,
/obj/structure/closet/crate/secure/loot{
	name = "locked crate"
	},
/obj/item/storage/toolbox/artistic,
/obj/effect/decal/cleanable/dirt/dust,
/turf/open/floor/plasteel/patterned/cargo_one,
/area/space)
"ka" = (
/obj/structure/table,
/turf/open/floor/plasteel/grimy,
/area/space)
"kb" = (
/turf/open/floor/engine,
/area/space)
"ku" = (
/obj/machinery/door/airlock/grunge,
/obj/structure/catwalk/over/plated_catwalk/dark,
/obj/structure/catwalk/over/plated_catwalk/dark,
/turf/open/floor/plating,
/area/space)
"kQ" = (
/turf/open/floor/pod/light,
/area/space)
"kS" = (
/obj/machinery/computer/apc_control{
	dir = 1
	},
/obj/machinery/light/small/broken,
/turf/open/floor/pod/light,
/area/space)
"lj" = (
/obj/item/storage/bag/money/vault,
/obj/structure/safe,
/obj/machinery/light/small{
	dir = 4
	},
/turf/open/floor/vault,
/area/space)
"ma" = (
/obj/structure/chair{
	dir = 1
	},
/obj/effect/turf_decal/corner/opaque/bar/diagonal,
/obj/effect/turf_decal/corner/opaque/beige/diagonal{
	dir = 8
	},
/turf/open/floor/plasteel/vaporwave,
/area/space)
"mc" = (
/obj/effect/turf_decal/trimline/opaque/brown/line{
	dir = 1
	},
/obj/effect/decal/cleanable/dirt/dust,
/turf/open/floor/plasteel/patterned/cargo_one,
/area/space)
"mA" = (
/obj/structure/closet/wall/red{
	pixel_y = 29
	},
/obj/item/gun/ballistic/automatic/pistol/commander,
/obj/item/gun/ballistic/automatic/pistol/commander,
/turf/open/floor/plasteel/patterned/grid,
/area/space)
"mV" = (
/obj/machinery/computer/crew{
	dir = 8
	},
/turf/open/floor/pod/light,
/area/space)
"nc" = (
/obj/machinery/atmospherics/components/unary/vent_pump/siphon/atmos/nitrogen_output{
	dir = 1;
	name = "inlet";
	on = 0
	},
/obj/machinery/light/small{
	dir = 8
	},
/obj/structure/catwalk/over/plated_catwalk/dark,
/turf/open/floor/plating,
/area/space)
"nB" = (
/obj/machinery/power/terminal{
	dir = 8
	},
/obj/structure/table/wood,
/obj/effect/decal/cleanable/dirt/dust,
/obj/effect/decal/cleanable/dirt/dust,
/turf/open/floor/plating,
/area/space)
"nF" = (
/obj/structure/table/wood,
/obj/effect/decal/cleanable/dirt/dust,
/turf/open/floor/plating,
/area/space)
"nP" = (
/obj/effect/turf_decal/trimline/opaque/brown/line{
	dir = 6
	},
/obj/effect/decal/cleanable/dirt/dust,
/obj/effect/decal/cleanable/dirt/dust,
/turf/open/floor/plasteel/patterned/cargo_one,
/area/space)
"nS" = (
/obj/structure/window/plasma/reinforced/spawner/west,
/obj/structure/window/plasma/reinforced/spawner,
/turf/open/floor/plating,
/area/space)
"og" = (
/obj/effect/turf_decal/trimline/opaque/brown/line{
	dir = 1
	},
/obj/structure/table,
/obj/item/storage/toolbox/mechanical{
	pixel_y = -1;
	pixel_x = 6
	},
/obj/item/reagent_containers/hypospray/medipen{
	pixel_y = 8;
	pixel_x = -10
	},
/obj/item/reagent_containers/hypospray/medipen{
	pixel_y = 12;
	pixel_x = -10
	},
/obj/item/storage/firstaid/regular{
	pixel_x = 5
	},
/obj/item/hatchet/wooden,
/turf/open/floor/plasteel/patterned/cargo_one,
/area/space)
"os" = (
/obj/machinery/power/terminal{
	dir = 8
	},
/obj/structure/bed,
/obj/item/bedsheet/orange,
/obj/effect/decal/cleanable/blood,
/turf/open/floor/plating,
/area/space)
"ot" = (
/obj/structure/railing,
/obj/machinery/atmospherics/pipe/manifold/brown/hidden{
	dir = 1
	},
/turf/open/floor/plasteel/tech/grid,
/area/space)
"oH" = (
/obj/structure/bed,
/obj/item/bedsheet/orange,
/obj/effect/decal/cleanable/blood,
/turf/open/floor/plating,
/area/space)
"po" = (
/obj/effect/decal/cleanable/dirt/dust,
/obj/effect/decal/cleanable/dirt/dust,
/obj/effect/decal/cleanable/dirt/dust,
/obj/structure/bed/dogbed,
/turf/open/floor/plating,
/area/space)
"ps" = (
/obj/machinery/atmospherics/pipe/simple/brown/hidden{
	dir = 10
	},
/obj/structure/railing,
/obj/effect/turf_decal/trimline/opaque/orange/filled/warning{
	dir = 4
	},
/obj/effect/decal/cleanable/dirt/dust,
/obj/effect/decal/cleanable/dirt/dust,
/turf/open/floor/plasteel/tech/grid,
/area/space)
"qt" = (
/obj/structure/chair{
	dir = 4
	},
/obj/structure/catwalk/over,
/turf/open/floor/plating,
/area/space)
"qy" = (
/obj/structure/closet,
/obj/machinery/light/small{
	dir = 8
	},
/turf/open/floor/pod/light,
/area/space)
"qX" = (
/obj/effect/decal/cleanable/dirt/dust,
/obj/effect/decal/cleanable/dirt/dust,
/turf/open/floor/plasteel/patterned/cargo_one,
/area/space)
"ri" = (
/obj/structure/railing{
	dir = 4
	},
/turf/open/floor/plasteel/stairs,
/area/space)
"ro" = (
/obj/machinery/power/smes/shuttle/precharged{
	dir = 4
	},
/obj/structure/window/reinforced{
	dir = 8
	},
/turf/open/floor/plating,
/area/space)
"rO" = (
/obj/structure/window/plasma/reinforced/spawner/west,
/obj/structure/window/plasma/reinforced/spawner/north,
/turf/open/floor/plating,
/area/space)
"rU" = (
/turf/open/floor/plasteel/patterned/cargo_one,
/area/space)
"sa" = (
/obj/machinery/atmospherics/pipe/heat_exchanging/junction,
/turf/closed/wall,
/area/space)
"sd" = (
/obj/effect/decal/fakelattice,
/turf/open/floor/plating,
/area/space)
"sH" = (
/obj/structure/bed,
/obj/item/bedsheet/random,
/obj/structure/curtain/cloth/grey,
/turf/open/floor/plasteel/grimy,
/area/space)
"sS" = (
/obj/machinery/door/airlock/external,
/obj/structure/catwalk/over,
/obj/effect/decal/cleanable/dirt/dust,
/turf/open/floor/plating,
/area/space)
"sW" = (
/obj/structure/dresser,
/turf/open/floor/plasteel/grimy,
/area/space)
"ts" = (
/obj/structure/catwalk/over/plated_catwalk/dark,
/obj/machinery/door/airlock/grunge,
/turf/open/floor/plating,
/area/space)
"uk" = (
/obj/structure/chair{
	dir = 1
	},
/obj/effect/turf_decal/corner/opaque/bar/diagonal,
/obj/effect/turf_decal/corner/opaque/beige/diagonal{
	dir = 8
	},
/obj/effect/decal/cleanable/dirt/dust,
/turf/open/floor/plasteel/vaporwave,
/area/space)
"ux" = (
/turf/open/floor/plasteel/grimy,
/area/space)
"uy" = (
/obj/effect/turf_decal/trimline/opaque/brown/line{
	dir = 8
	},
/obj/effect/turf_decal/industrial/stand_clear{
	dir = 4
	},
/turf/open/floor/plasteel/patterned/cargo_one,
/area/space)
"uF" = (
/obj/machinery/atmospherics/pipe/manifold/brown/hidden,
/turf/open/floor/plasteel/tech/grid,
/area/space)
"uN" = (
/turf/open/floor/plasteel/patterned/ridged,
/area/space)
"uQ" = (
/obj/machinery/cryopod{
	dir = 4
	},
/turf/open/floor/plasteel/tech/grid,
/area/space)
"vB" = (
/obj/structure/catwalk/over,
/obj/effect/decal/cleanable/dirt/dust,
/turf/open/floor/plating,
/area/space)
"vV" = (
/obj/structure/catwalk/over/plated_catwalk/dark,
/obj/machinery/atmospherics/components/unary/outlet_injector/atmos/nitrogen_input{
	name = "injector";
	on = 0
	},
/obj/structure/tank_dispenser/oxygen,
/obj/structure/railing,
/turf/open/floor/plating,
/area/space)
"wk" = (
/obj/machinery/power/shuttle/engine/electric{
	dir = 4
	},
/turf/open/floor/plating,
/area/space)
"wr" = (
/obj/machinery/suit_storage_unit/inherit/industrial,
/obj/machinery/atmospherics/components/unary/vent_pump/siphon/atmos/nitrogen_output{
	dir = 1;
	name = "inlet";
	on = 0
	},
/obj/item/clothing/suit/space/eva,
/obj/item/clothing/head/helmet/space/eva,
/obj/structure/catwalk/over/plated_catwalk/dark,
/turf/open/floor/plating,
/area/space)
"wN" = (
/obj/effect/turf_decal/trimline/opaque/brown/line{
	dir = 1
	},
/obj/structure/closet/crate/medical,
/obj/item/stack/medical/splint/ghetto,
/obj/item/stack/medical/splint/ghetto,
/obj/item/stack/medical/bruise_pack/herb,
/obj/item/stack/medical/ointment/herb,
/obj/item/stack/medical/suture/medicated,
/obj/effect/decal/cleanable/dirt/dust,
/turf/open/floor/plasteel/patterned/cargo_one,
/area/space)
"xb" = (
/obj/structure/chair/office{
	dir = 1
	},
/turf/open/floor/pod/light,
/area/space)
"xt" = (
/obj/machinery/power/smes/engineering,
/obj/machinery/power/smes/engineering,
/obj/machinery/light/small/broken,
/turf/open/floor/plasteel/tech/grid,
/area/space)
"xB" = (
/obj/machinery/computer/atmos_control/tank/nitrogen_tank{
	dir = 1;
	name = "Cargo Bay Control"
	},
/obj/machinery/atmospherics/components/unary/vent_pump/siphon/atmos/nitrogen_output{
	dir = 1;
	name = "inlet";
	on = 0
	},
/obj/structure/catwalk/over/plated_catwalk/dark,
/turf/open/floor/plating,
/area/space)
"xQ" = (
/obj/structure/window/spawner/east,
/obj/effect/decal/cleanable/blood,
/turf/open/floor/plating,
/area/space)
"xT" = (
/obj/structure/closet,
/turf/open/floor/plasteel/tech/grid,
/area/space)
"xW" = (
/obj/machinery/air_sensor/atmos/air_tank,
/obj/structure/window/plasma/reinforced/spawner/north,
/turf/open/floor/engine/air,
/area/space)
"yE" = (
/obj/structure/table,
/turf/open/floor/plasteel/tech/grid,
/area/space)
"yQ" = (
/obj/structure/closet/crate/bin,
/turf/open/floor/plasteel/tech/techmaint,
/area/space)
"zz" = (
/obj/effect/spawner/structure/window/plasma/reinforced,
/turf/open/floor/plating,
/area/space)
"zG" = (
/obj/machinery/door/airlock/grunge,
/obj/structure/catwalk/over/plated_catwalk/dark,
/turf/open/floor/plating,
/area/space)
"An" = (
/obj/machinery/autolathe/hacked,
/turf/open/floor/plasteel/tech/grid,
/area/space)
"AP" = (
/obj/machinery/power/terminal{
	dir = 8
	},
/obj/effect/decal/cleanable/dirt/dust,
/turf/open/floor/plating,
/area/space)
"Cp" = (
/obj/structure/railing,
/turf/open/floor/plasteel/patterned/grid,
/area/space)
"CC" = (
/obj/structure/grille,
/turf/open/floor/plating,
/area/space)
"CS" = (
/obj/machinery/light_switch{
	dir = 4;
	pixel_x = -25;
	pixel_y = -8
	},
/obj/structure/railing,
/turf/open/floor/plasteel/patterned/grid,
/area/space)
"Dc" = (
/obj/structure/window/spawner/east,
/obj/effect/decal/cleanable/dirt/dust,
/turf/open/floor/plating,
/area/space)
"DO" = (
/obj/effect/turf_decal/borderfloor{
	dir = 1
	},
/turf/open/floor/plasteel/mono/dark,
/area/space)
"DP" = (
/obj/effect/turf_decal/trimline/opaque/brown/line{
	dir = 1
	},
/turf/open/floor/plasteel/patterned/cargo_one,
/area/space)
"Ec" = (
/obj/machinery/atmospherics/pipe/manifold/brown/hidden,
/obj/effect/decal/cleanable/dirt/dust,
/obj/effect/decal/cleanable/dirt/dust,
/turf/open/floor/plasteel/tech/grid,
/area/space)
"Ed" = (
/obj/structure/catwalk/over/plated_catwalk/dark,
/obj/machinery/atmospherics/components/unary/outlet_injector/atmos/nitrogen_input{
	name = "injector";
	on = 0
	},
/obj/machinery/ore_silo,
/obj/structure/railing,
/turf/open/floor/plating,
/area/space)
"Es" = (
/obj/structure/window/plasma/reinforced/spawner,
/obj/structure/window/plasma/reinforced/spawner/west,
/obj/structure/window/plasma/reinforced/spawner/east,
/turf/open/floor/plating,
/area/space)
"Ey" = (
/obj/structure/window/plasma/reinforced/spawner/north,
/obj/structure/window/plasma/reinforced/spawner/west,
/turf/open/floor/engine/air,
/area/space)
"EM" = (
/obj/structure/table/reinforced,
/obj/machinery/microwave{
	pixel_y = 4;
	pixel_x = -1
	},
/obj/effect/turf_decal/corner/opaque/bar/diagonal,
/obj/effect/turf_decal/corner/opaque/beige/diagonal{
	dir = 8
	},
/turf/open/floor/plasteel/vaporwave,
/area/space)
"EX" = (
/obj/machinery/door/airlock/external/glass,
/obj/structure/catwalk/over,
/obj/effect/decal/cleanable/dirt/dust,
/turf/open/floor/plating,
/area/space)
"Fm" = (
/obj/structure/frame/computer{
	dir = 8
	},
/turf/open/floor/pod/light,
/area/space)
"Gp" = (
/obj/structure/catwalk/over,
/obj/machinery/door/airlock/external/glass,
/turf/open/floor/plating,
/area/space)
"Ha" = (
/obj/structure/railing{
	dir = 8
	},
/turf/open/floor/plasteel/stairs,
/area/space)
"HL" = (
/turf/open/floor/plasteel/patterned/grid,
/area/space)
"HO" = (
/obj/effect/turf_decal/corner/opaque/bar/diagonal,
/obj/effect/turf_decal/corner/opaque/beige/diagonal{
	dir = 8
	},
/obj/effect/decal/cleanable/dirt/dust,
/turf/open/floor/plasteel/vaporwave,
/area/space)
"IL" = (
/obj/structure/closet/crate/bin,
/turf/open/floor/plasteel/mono/dark,
/area/space)
"Ju" = (
/obj/machinery/power/terminal{
	dir = 8
	},
/turf/open/floor/plating,
/area/space)
"JM" = (
/obj/structure/frame/computer,
/turf/open/floor/pod/light,
/area/space)
"JW" = (
/obj/structure/window/plasma/reinforced/spawner/east,
/obj/structure/window/plasma/reinforced/spawner,
/turf/open/floor/engine/air,
/area/space)
"Ke" = (
/obj/effect/turf_decal/trimline/opaque/brown/line{
	dir = 1
	},
/obj/structure/closet/crate/secure/loot{
	name = "locked crate"
	},
/obj/item/storage/toolbox/mechanical,
/turf/open/floor/plasteel/patterned/cargo_one,
/area/space)
"Ki" = (
/obj/structure/catwalk/over/plated_catwalk/dark,
/turf/open/floor/plating,
/area/space)
"KP" = (
/obj/effect/turf_decal/trimline/opaque/brown/line{
	dir = 10
	},
/obj/effect/decal/cleanable/blood,
/obj/structure/fermenting_barrel,
/turf/open/floor/plasteel/patterned/cargo_one,
/area/space)
"KT" = (
/obj/structure/sink{
	pixel_y = 30
	},
/turf/open/floor/plastic,
/area/space)
"Lc" = (
/obj/machinery/modular_computer/console/preset/command{
	dir = 1
	},
/turf/open/floor/pod/light,
/area/space)
"Ll" = (
/obj/effect/turf_decal/trimline/opaque/brown/line,
/obj/structure/closet/crate/secure/loot{
	name = "locked crate"
	},
/obj/item/storage/backpack/satchel/flat,
/turf/open/floor/plasteel/patterned/cargo_one,
/area/space)
"Lw" = (
/obj/structure/table,
/turf/open/floor/plasteel/tech,
/area/space)
"Lx" = (
/obj/structure/window/plasma/reinforced/spawner,
/obj/structure/window/plasma/reinforced/spawner/east,
/turf/open/floor/plating,
/area/space)
"LG" = (
/obj/effect/turf_decal/corner/opaque/bar/diagonal,
/obj/effect/turf_decal/corner/opaque/beige/diagonal{
	dir = 8
	},
/turf/open/floor/plasteel/vaporwave,
/area/space)
"LH" = (
/obj/effect/decal/cleanable/dirt/dust,
/turf/open/floor/plating,
/area/space)
"Mp" = (
/obj/effect/turf_decal/trimline/opaque/brown/line{
	dir = 4
	},
/turf/open/floor/plasteel/patterned/cargo_one,
/area/space)
"MM" = (
/obj/machinery/door/airlock/grunge,
/turf/open/floor/pod/light,
/area/space)
"MU" = (
/obj/effect/decal/cleanable/blood/drip,
/turf/open/floor/plasteel/patterned/cargo_one,
/area/space)
"MW" = (
/obj/machinery/light_switch{
	dir = 4;
	pixel_x = -25;
	pixel_y = -8
	},
/obj/machinery/door/airlock/vault,
/turf/open/floor/vault,
/area/space)
"Ob" = (
/obj/structure/catwalk/over,
/obj/machinery/advanced_airlock_controller{
	pixel_x = -32;
	pixel_y = 6
	},
/turf/open/floor/plating,
/area/space)
"Og" = (
/obj/effect/turf_decal/trimline/opaque/brown/line{
	dir = 9
	},
/obj/machinery/light/small{
	dir = 1
	},
/obj/structure/bed/roller,
/obj/effect/decal/cleanable/blood,
/obj/effect/decal/cleanable/dirt/dust,
/turf/open/floor/plasteel/patterned/cargo_one,
/area/space)
"OC" = (
/obj/structure/catwalk/over,
/obj/machinery/door/airlock/external,
/turf/open/floor/plating,
/area/space)
"OJ" = (
/obj/machinery/door/airlock/grunge,
/turf/open/floor/plasteel/tech,
/area/space)
"OY" = (
/obj/machinery/atmospherics/pipe/simple/brown/hidden{
	dir = 4
	},
/obj/machinery/door/poddoor/shutters{
	id = "Internal";
	name = "internal shutters"
	},
/obj/structure/catwalk/over/plated_catwalk/dark,
/obj/structure/catwalk/over/plated_catwalk/dark,
/turf/open/floor/plating,
/area/space)
"Pe" = (
/obj/structure/closet/crate,
/obj/item/storage/box/donkpockets,
/obj/effect/turf_decal/corner/opaque/bar/diagonal,
/obj/effect/turf_decal/corner/opaque/beige/diagonal{
	dir = 8
	},
/turf/open/floor/plasteel/vaporwave,
/area/space)
"PZ" = (
/obj/structure/closet/crate/bin,
/obj/effect/turf_decal/corner/opaque/bar/diagonal,
/obj/effect/turf_decal/corner/opaque/beige/diagonal{
	dir = 8
	},
/obj/item/grenade/stingbang,
/turf/open/floor/plasteel/vaporwave,
/area/space)
"Qk" = (
/obj/structure/table,
/obj/machinery/microwave,
/turf/open/floor/plasteel/grimy,
/area/space)
"Qu" = (
/obj/structure/table,
/obj/item/candle/infinite{
	pixel_y = 5;
	anchored = 1
	},
/obj/structure/catwalk/over,
/turf/open/floor/plating,
/area/space)
"Rm" = (
/obj/effect/turf_decal/trimline/opaque/brown/line{
	dir = 10
	},
/obj/machinery/light_switch{
	dir = 1;
	pixel_x = 5;
	pixel_y = -25
	},
/obj/structure/closet/crate/secure/loot{
	name = "locked crate"
	},
/obj/item/weldingtool/experimental,
/obj/effect/decal/cleanable/dirt/dust,
/turf/open/floor/plasteel/patterned/cargo_one,
/area/space)
"RM" = (
/obj/structure/chair/office/light,
/turf/open/floor/pod/light,
/area/space)
"RY" = (
/obj/machinery/suit_storage_unit/inherit/industrial,
/turf/open/floor/plasteel/patterned/ridged,
/area/space)
"Ss" = (
/obj/effect/turf_decal/trimline/opaque/brown/line{
	dir = 6
	},
/obj/machinery/light/small/broken,
/obj/effect/decal/cleanable/dirt/dust,
/turf/open/floor/plasteel/patterned/cargo_one,
/area/space)
"Su" = (
/obj/machinery/power/terminal,
/turf/open/floor/plasteel/tech/grid,
/area/space)
"SA" = (
/obj/effect/decal/cleanable/blood/drip,
/obj/effect/decal/cleanable/dirt/dust,
/turf/open/floor/plasteel/patterned/cargo_one,
/area/space)
"SK" = (
/obj/effect/turf_decal/trimline/opaque/brown/line{
	dir = 8
	},
/obj/effect/turf_decal/industrial/stand_clear{
	dir = 4
	},
/obj/effect/decal/cleanable/dirt/dust,
/turf/open/floor/plasteel/patterned/cargo_one,
/area/space)
"SZ" = (
/turf/open/floor/plating,
/area/space)
"Tn" = (
/obj/structure/railing,
/obj/machinery/atmospherics/pipe/manifold/brown/hidden{
	dir = 1
	},
/obj/effect/decal/cleanable/dirt/dust,
/turf/open/floor/plasteel/tech/grid,
/area/space)
"Tr" = (
/obj/structure/table/reinforced,
/obj/effect/turf_decal/corner/opaque/bar/diagonal,
/obj/effect/turf_decal/corner/opaque/beige/diagonal{
	dir = 8
	},
/obj/machinery/light/small{
	dir = 1
	},
/turf/open/floor/plasteel/vaporwave,
/area/space)
"TF" = (
/obj/structure/table/reinforced,
/obj/effect/turf_decal/corner/opaque/bar/diagonal,
/obj/effect/turf_decal/corner/opaque/beige/diagonal{
	dir = 8
	},
/turf/open/floor/plasteel/vaporwave,
/area/space)
"Ua" = (
/obj/structure/bed,
/obj/effect/decal/cleanable/dirt/dust,
/turf/open/floor/plating,
/area/space)
"Ub" = (
/obj/machinery/light/small{
	dir = 8
	},
/turf/open/floor/plasteel/tech/grid,
/area/space)
"Uo" = (
/obj/effect/turf_decal/borderfloor{
	dir = 1
	},
/obj/machinery/light/small{
	dir = 1
	},
/turf/open/floor/plasteel/mono/dark,
/area/space)
"UK" = (
/obj/structure/railing{
	dir = 4
	},
/turf/open/floor/plasteel/stairs{
	dir = 1
	},
/area/space)
"UR" = (
/obj/structure/window/plasma/reinforced/spawner/north,
/obj/structure/window/plasma/reinforced/spawner/east,
/turf/open/floor/plating,
/area/space)
"Vr" = (
/obj/effect/decal/cleanable/blood,
/turf/open/floor/plasteel/patterned/cargo_one,
/area/space)
"Vt" = (
/obj/structure/chair{
	dir = 8
	},
/obj/structure/catwalk/over,
/turf/open/floor/plating,
/area/space)
"Vv" = (
/obj/structure/safe/floor,
/obj/item/gun/ballistic/shotgun/doublebarrel,
/obj/item/hatchet/wooden,
/obj/item/kitchen/knife/combat,
/obj/item/clothing/suit/space/pilot,
/obj/item/clothing/head/helmet/space/pilot/random,
/turf/open/floor/pod/light,
/area/space)
"VA" = (
/obj/effect/turf_decal/industrial/warning{
	dir = 8
	},
/turf/open/floor/plasteel/tech,
/area/space)
"VS" = (
/obj/effect/spawner/structure/window/reinforced,
/turf/open/floor/plating,
/area/space)
"Wu" = (
/obj/structure/closet/secure_closet/freezer/fridge,
/turf/open/floor/plasteel/grimy,
/area/space)
"WF" = (
/obj/effect/decal/cleanable/dirt/dust,
/obj/effect/decal/cleanable/dirt/dust,
/turf/open/floor/plating,
/area/space)
"WJ" = (
/obj/machinery/atmospherics/pipe/heat_exchanging/junction{
	dir = 1
	},
/turf/closed/wall,
/area/space)
"WL" = (
/obj/structure/closet/cabinet,
/obj/effect/decal/cleanable/dirt/dust,
/obj/effect/decal/cleanable/dirt/dust,
/turf/open/floor/plating,
/area/space)
"WW" = (
/obj/machinery/computer/helm{
	dir = 8
	},
/turf/open/floor/pod/light,
/area/space)
"XG" = (
/obj/machinery/computer/card{
	dir = 8
	},
/turf/open/floor/pod/light,
/area/space)
"XW" = (
/obj/structure/catwalk/over/plated_catwalk/dark,
/obj/machinery/atmospherics/components/unary/outlet_injector/atmos/nitrogen_input{
	name = "injector";
	on = 0
	},
/obj/structure/rack,
/obj/structure/railing,
/turf/open/floor/plating,
/area/space)
"Yx" = (
/obj/structure/closet,
/turf/open/floor/pod/light,
/area/space)
"YR" = (
/obj/structure/closet/firecloset{
	anchored = 1
	},
/turf/open/floor/plasteel/tech/techmaint,
/area/space)
"YY" = (
/obj/structure/closet/wall/red{
	pixel_y = 29
	},
/obj/item/gun/ballistic/shotgun/doublebarrel/improvised,
/obj/item/gun/ballistic/shotgun/doublebarrel/improvised,
/turf/open/floor/plasteel/patterned/grid,
/area/space)
"Zq" = (
/obj/structure/catwalk/over/plated_catwalk/dark,
/obj/structure/catwalk/over/plated_catwalk/dark,
/turf/open/floor/plating,
/area/space)
"Zr" = (
/obj/structure/catwalk/over/plated_catwalk/dark,
/obj/machinery/atmospherics/components/unary/outlet_injector/atmos/nitrogen_input{
	name = "injector";
	on = 0
	},
/obj/machinery/computer/cargo/express,
/obj/structure/railing,
/obj/machinery/light/small{
	dir = 1
	},
/turf/open/floor/plating,
/area/space)
"Zt" = (
/turf/template_noop,
/area/space)
"ZY" = (
/obj/machinery/power/smes/shuttle/precharged{
	dir = 4
	},
/obj/structure/window/reinforced{
	dir = 8
	},
/obj/effect/decal/cleanable/dirt/dust,
/turf/open/floor/plating,
/area/space)

(1,1,1) = {"
Zt
Zt
Zt
Zt
Zt
Zt
Zt
Zt
Zt
bI
sS
sS
bI
Zt
Zt
Zt
Zt
Zt
Zt
Zt
Zt
Zt
"}
(2,1,1) = {"
Zt
Zt
Zt
Zt
Zt
Zt
Zt
Zt
bI
bI
vB
vB
bI
bI
Zt
Zt
Zt
Zt
Zt
Zt
Zt
Zt
"}
(3,1,1) = {"
Zt
Zt
Zt
Zt
Zt
Zt
bI
wk
bI
bI
EX
EX
bI
bI
wk
bI
Zt
Zt
Zt
Zt
Zt
Zt
"}
(4,1,1) = {"
Zt
Zt
Zt
Zt
bI
wk
bI
ek
bI
ii
SK
uy
KP
bI
ro
bI
wk
bI
Zt
Zt
Zt
Zt
"}
(5,1,1) = {"
Zt
Zt
Zt
bI
bI
ek
jJ
os
jJ
Ke
hs
hs
jM
bI
nB
nF
ZY
bI
bI
Zt
Zt
Zt
"}
(6,1,1) = {"
Zt
Zt
Zt
bI
oH
Ju
po
SZ
jJ
DP
hs
rU
jB
jJ
LH
WF
AP
WL
bI
Zt
Zt
Zt
"}
(7,1,1) = {"
CC
Zt
bI
bI
bu
Dc
xQ
Dc
bI
mc
rU
Vr
be
bI
LH
LH
WF
Ua
bI
bI
Zt
CC
"}
(8,1,1) = {"
CC
sd
bI
bI
LG
HO
HO
LG
PZ
hx
Mp
Mp
nP
bI
bI
ed
jJ
jJ
bI
bI
sd
CC
"}
(9,1,1) = {"
CC
Zt
bI
Tr
uk
HO
LG
HO
HO
rU
rU
rU
rU
hX
hX
DO
aM
uN
RY
bI
Zt
CC
"}
(10,1,1) = {"
CC
Zt
bI
TF
LG
LG
LG
Pe
bI
bI
MM
bE
jJ
bI
IL
DO
aM
uN
RY
bI
Zt
CC
"}
(11,1,1) = {"
CC
sd
bI
TF
ma
LG
HO
bI
bI
qy
kQ
kQ
Yx
bI
bI
Uo
aM
uN
RY
bI
sd
CC
"}
(12,1,1) = {"
CC
Zt
bI
EM
HO
LG
LG
bI
JM
kQ
kQ
Vv
kQ
kS
bI
DO
aM
bI
bI
bI
Zt
CC
"}
(13,1,1) = {"
Zt
Zt
WJ
Tr
ma
HO
LG
VS
JM
xb
kQ
kQ
RM
Lc
VS
DO
aM
Gp
Ob
OC
Zt
Zt
"}
(14,1,1) = {"
Zt
Zt
bI
bI
bI
ts
bI
bI
bI
mV
Fm
WW
XG
bI
bI
bI
ts
bI
jJ
bI
Zt
Zt
"}
(15,1,1) = {"
Zt
Zt
bI
jb
CS
Ki
bI
dj
bI
bI
VS
VS
bI
bI
cg
MW
Ki
Ub
xT
bI
Zt
Zt
"}
(16,1,1) = {"
Zt
Zt
WJ
YY
HL
Ki
bI
KT
bI
Og
bD
aO
Rm
bI
lj
bI
Ki
gC
yE
sa
Zt
Zt
"}
(17,1,1) = {"
Zt
Zt
bI
mA
Cp
Ki
bI
OJ
bI
og
qX
MU
Ll
bI
jJ
bI
Ki
cw
cK
bI
Zt
Zt
"}
(18,1,1) = {"
Zt
Zt
bI
dA
Cp
Ki
yQ
gC
bI
wN
SA
rU
cO
bI
YR
yQ
Ki
gC
yE
bI
Zt
Zt
"}
(19,1,1) = {"
Zt
Zt
bI
bI
bI
Ki
Ki
Ki
hC
Ha
Ki
Ki
gH
hC
Ki
Ki
Zq
gC
An
bI
Zt
Zt
"}
(20,1,1) = {"
Zt
Zt
OC
Ob
Gp
Ki
Ki
Ki
hC
ri
Ki
Ki
UK
hC
Ki
Ki
Ki
cw
bS
bI
Zt
Zt
"}
(21,1,1) = {"
Zt
Zt
bI
bI
bI
bI
zG
bI
bI
ei
Ki
Ki
Ss
bI
bI
bI
iq
bI
bI
bI
Zt
Zt
"}
(22,1,1) = {"
CC
Zt
bI
uQ
uQ
dl
gA
qt
bI
bI
OY
OY
bI
bI
rO
nS
Ki
Su
xt
bI
Zt
CC
"}
(23,1,1) = {"
CC
sd
bI
fO
VA
dl
gA
Qu
VS
vV
uF
ot
nc
VS
UR
Lx
Ki
Ey
en
bI
sd
CC
"}
(24,1,1) = {"
CC
Zt
bI
Lw
fg
zG
gA
Vt
bI
XW
uF
Tn
wr
bI
cs
Es
Ki
xW
bH
bI
Zt
CC
"}
(25,1,1) = {"
CC
Zt
bI
bI
jJ
bI
ku
bI
bI
Zr
Ec
Tn
wr
bI
SZ
SZ
Ki
hq
JW
bI
Zt
CC
"}
(26,1,1) = {"
CC
sd
bI
fC
ux
ux
ux
Qk
VS
Ed
eu
ps
xB
VS
SZ
SZ
Ki
Ki
Ki
bI
sd
CC
"}
(27,1,1) = {"
CC
Zt
bI
ka
ux
ux
ux
ka
bI
bI
vB
vB
bI
bI
SZ
SZ
SZ
SZ
SZ
bI
Zt
CC
"}
(28,1,1) = {"
Zt
Zt
bI
sW
ux
ux
ux
Wu
bI
vB
vB
vB
vB
bI
bI
zz
zz
zz
bI
bI
Zt
Zt
"}
(29,1,1) = {"
Zt
Zt
bI
bI
sH
sH
sH
bI
bI
Zt
Zt
Zt
Zt
bI
bI
kb
kb
kb
bI
bI
Zt
Zt
"}
(30,1,1) = {"
Zt
Zt
Zt
bI
bI
bI
bI
bI
Zt
Zt
Zt
Zt
Zt
Zt
bI
bI
kb
bI
bI
Zt
Zt
Zt
"}
